песочница: песочница 
новый: новая новый 
ещё: ещё 
найти: найти нашли 
типизация: типизация 
си: си 
ребенок: детей 
обзор: обзор 
успех: успеха 
согласие: согласие 
центр: центр 
петербург: петербург 
рекурсия: рекурсия 
терминал: терминала 
знакомство: знакомство 
связная: связные 
визуализация: визуализация 
подробный: подробнее 
реклама: реклама 
масштабируемость: масштабируемость 
политика: политика 
суперкомпьютер: суперкомпьютеры 
парсинг: парсинг 
поразрядный: поразрядная 
санкт: санкт 
вероятность: вероятностей 
она: ней 
сейчас: сейчас 
теория: теория 
график: график графика 
область: области 
весь: все всём 
кодстайл: кодстайл 
структура: структуры 
информационный: информационная 
программирование: программирование программированию программирования 
оптимизация: оптимизация 
сложность: сложности 
статистик: статистика 
практика: практика 
проект: проектами проектов проекты 
время: время 
создавать: создавай создавать 
социальный: социальные 
соцсеть: соцсетях 
нажатие: нажатием 
данный: данные данных 
главный: главном 
данные: данные данных 
перевод: переводы 
обучать: обучающие 
маркетинг: маркетинг 
публикация: публикация 
написать: написать 
соглашаться: соглашаюсь 
викторина: викторины 
майнинг: майнинг 
автоматизирование: автоматизирование 
кодировка: кодировками 
методология: методологии 
стажировка: стажировка 
алиса: алиса 
ключевой: ключевых 
ориентированный: ориентированное 
редполитика: редполитика 
основный: основные 
глубинный: глубинным 
задача: задачи 
дополнить: дополненная 
бета: бета 
закрыть: закрыть 
карьер: карьера 
инженер: инженер 
система: системы 
читать: читать 
описать: опишите 
пользование: пользования 
база: базы 
цифровой: цифровой 
оценивать: оценивать 
командный: командной 
совет: советы 
видео: видео 
интересный: интересные интересных 
тьюринг: тьюринга 
динамический: динамическая 
пример: примерами 
оценить: оценить 
связный: связные 
редполитик: редполитика 
рефакторинг: рефакторинг 
графика: график графика 
функциональный: функциональное функциональный 
микросервис: микросервисы 
бренд: брендам 
заказной: заказной 
курс: курсы 
хобби: хобби 
математик: математика 
карта: карты 
бирюков: бирюков 
крка: крок 
роскомнадзор: роскомнадзор 
калифорний: калифорнии 
технология: технологии технологиям 
викторин: викторины 
повторить: повторить 
вычисление: вычисления 
зрение: зрение 
москва: москва 
гибкий: гибкий 
хак: хак 
мобильный: мобильная 
команда: команду 
большой: больше 
павел: павел 
удалённый: удалённо 
калифорния: калифорнии 
конференция: конференции конференция 
написание: написание 
секунда: секунд 
баги: баги 
кода: код 
навык: навыки 
дая: даю 
чипокалипсис: чипокалипсис 
архитектура: архитектура 
обучение: обучение обучением обучения 
программист: программистов 
друзь: друзей 
обработка: обработка обработку 
умный: умный 
это: это 
код: код 
рост: рост 
паттерн: паттерны 
опрос: опрос 
новость: новости 
математика: математика 
стоить: стоит 
наслать: нашли 
криптовалюта: криптовалюты 
красивый: красивый 
начинающий: начинающих 
войти: войти 
старт: старт 
звук: звуком 
память: памяти 
политик: политика 
принтер: принтер 
разбор: разбором 
быстрый: быстрый 
хороший: лучшая лучший хорош 
много: больше 
коротко: коротко 
облачный: облачные 
асинхронный: асинхронное 
фрагмент: фрагмент 
карьера: карьера 
разместить: разместить 
выражение: выражения 
конфиденциальность: конфиденциальности 
облако: облака 
нейрочип: нейрочип 
продолжать: продолжающих 
чего: чего 
список: списки 
пост: пост постов посты 
администрирование: администрирование 
ошибка: ошибке ошибки 
криптография: криптография 
аналитика: аналитика 
увы: увы 
взлом: взлом 
дизайн: дизайн дизайну 
искусственный: искусственный 
игра: игр игра игры 
ува: увы 
компания: компании компаний компания 
собеседование: собеседование 
хакер: хакеры 
бэкенд: бэкенд 
гайда: гайд 
главное: главном 
ответ: ответы 
сленг: сленг 
баг: баг баги 
больший: больше 
интервью: интервью 
издание: издание 
кто: кто 
повысить: повышенной 
баз: базы 
стечь: стеки 
сетевой: сетевые 
пользователь: пользователя 
событие: событий события 
подборка: подборки 
электромобиль: электромобиль 
алгоритм: алгоритмы 
беспилотник: беспилотники 
мотивация: мотивации 
материал: материал материалы 
утечка: утечка 
конкурс: конкурс 
сообщить: сообщить 
соревнование: соревнования 
аналитик: аналитика 
пошаговый: пошаговый 
нагрузка: нагрузки 
вести: ведущая 
продвинуть: продвинутых 
разработка: разработка разработке разработки 
пасхалка: пасхалки 
практик: практика 
начинающая: начинающих 
этот: это 
запись: записи 
интеллект: интеллект 
приложение: приложение 
ведущая: ведущая 
друг: друзей 
стартап: стартапы 
нейронный: нейронные 
джейлбрейк: джейлбрейк 
правило: правила правилами 
основной: основные 
схема: схема 
прочитать: прочитать 
удаться: удалось 
можно: можно 
дуров: дуров 
дать: данные данных 
космос: космос 
персональный: персональные персональных 
оружие: оружие 
английский: английский английском 
сортировка: сортировка 
массив: массивы 
во: во 
пользовательский: пользовательское 
хранение: хранения 
дата: дата 
очередь: очереди 
вы: вы 
образование: образование образования 
пожалуйста: пожалуйста 
веб: веб 
паспорт: паспорт 
производительность: производительность 
квантовый: квантовые 
регулярный: регулярные 
узнать: узнайте узнать 
задачка: задачки 
интернет: интернет 
россия: россия 
тест: тесты 
простой: простым простых 
выделить: выделите 
ретро: ретро 
популярный: популярные 
олимпиадный: олимпиадное 
здесь: здесь 
компилятор: компиляторы 
авторский: авторское 
сайт: сайта сайте сайтом 
связать: связано 
правый: право 
низкоуровневый: низкоуровневое 
ориентировать: ориентированное 
работа: работа работы 
давать: даю 
загрузить: загрузить 
ожидание: ожидание 
сеть: сети 
направление: направлениям 
блог: блоги блогов 
фреймворк: фреймворки 
биотехнология: биотехнологии 
интерфейс: интерфейс интерфейсов 
дрон: дроны 
операционный: операционные 
связной: связные 
угадайка: угадайки 
короткий: коротко 
боты: боты 
что: чего 
эксперт: эксперт экспертов 
править: правила 
бизнес: бизнес 
прага: прага прагу 
будущий: будущее 
магистратура: магистратура 
маска: маск 
согласиться: согласитесь 
переезд: переезд переезда 
дом: дом 
мероприятие: мероприятия 
поток: потоки 
чум: чумы 
проектирование: проектирования 
статья: статьи 
реактивный: реактивное 
принцип: принципы 
вещий: вещей 
музыка: музыка 
ограничение: ограничения 
илона: илон 
посвятить: посвящённая 
умерить: умеренной 
ит: ит 
техподдержка: техподдержка 
больше: больше 
машинный: машинное 
контакт: контакте 
язык: язык языкам языке языки языком 
комментарий: комментарии 
робот: роботы 
ия: ии 
план: планы 
тема: темы 
строка: строки 
хоккей: хоккея 
сервис: сервис сервисы 
тестирование: тестирование тестированием 
фронтенд: фронтенд 
распознавание: распознавание 
связанный: связано 
анализ: анализ 
право: право 
уязвимость: уязвимость 
стоять: стоит 
будущее: будущее 
год: год 
международный: международная 
мессенджер: мессенджер 
реальность: реальность 
сбер: сбер 
управление: управление 
безопасность: безопасность 
ведущий: ведущая 
мая: мая 
автопилот: автопилот 
блокчейн: блокчейн 
уведомление: уведомления 
чума: чумы 
практикум: практикум 
май: мая 
финтех: финтех 
объектный: объектно 
авторизоваться: авторизуйтесь 
вещь: вещей 
гостевой: гостевая 
повышенный: повышенной 
улучшить: улучшить 
шаблон: шаблоны 
инструмент: инструменты 
бирюк: бирюков 
системный: системное системный 
стек: стеки 
создание: создание 
иван: иван 
несколько: несколько 
динамика: динамика 
отправить: отправить отправьте 
ассемблер: ассемблера 
проходить: проходила 
вакансия: вакансии вакансию 
мы: мы нам нас 
партнёрский: партнёрский 
процессор: процессор 
динамик: динамика 
топ: топ 
использовать: используем 
не: не 
опечатка: опечатку 
протокол: протоколы 
организация: организация 
стека: стеки 
соглашение: соглашение 
онлайн: онлайн 
премия: премия 
шпаргалка: шпаргалки 
блокировка: блокировки 
писать: писать 
сервер: сервер серверы 
бот: боты 
история: история 
многопоточность: многопоточность 
начинать: начинающих 
яндекс: яндекс 
цветовой: цветовая 
виртуальный: виртуальная 
формат: форматы 
сотрудничество: сотрудничество 
головоломка: головоломки 
поиск: поиск поиске 
статистика: статистика 
умеренный: умеренной 
все: все 
возможность: возможностью 
продажа: продаж 
фильм: фильмы 
безопасный: безопасный 
крестик: крестик 
занять: займет 
подготовить: подготовили 
ежегодный: ежегодная 
всё: всём 
юмор: юмор 
высокий: высокие 
наука: наука 
отладка: отладка 
браузер: браузеры 
компьютерный: компьютерная компьютерное 
книга: книги 
рубрика: рубрики 
